0 0 0 0 0 0 0 0 0 0 0 0 0 0 0 0 0 0 0 0
0 0 0 0 0 0 0 0 0 0 0 0 0 0 0 0 0 0 0 0
0 0 0 0 0 0 0 0 0 0 0 0 0 0 0 0 0 0 0 0
0 0 0 0 0 0 0 0 0 0 0 0 0 0 0 0 0 0 0 0
0 0 0 0 0 0 0 0 0 0 0 0 0 0 0 0 0 0 0 0
0 0 0 0 0 0 1 1 1 1 1 1 1 1 1 1 0 0 0 0
0 0 0 0 0 0 1 2 2 5 5 1 5 5 5 1 0 0 0 0
0 0 0 0 0 0 1 2 2 5 5 5 5 5 5 1 0 0 0 0
0 0 0 0 0 0 1 2 2 5 5 1 5 5 1 1 1 1 0 0
0 0 0 0 0 1 1 1 1 1 1 1 5 5 1 5 5 1 1 0
0 0 0 0 0 1 5 5 5 5 5 5 5 5 5 5 5 5 1 0
0 0 0 0 0 1 5 5 1 5 5 1 1 5 5 1 5 5 1 0
0 0 0 1 1 1 1 5 1 1 5 5 1 1 1 1 5 1 1 0
0 0 0 1 5 5 3 5 5 1 1 1 1 1 5 1 5 5 1 0
0 0 0 1 5 1 5 3 5 5 3 5 5 1 5 3 5 5 1 0
0 0 0 1 5 4 3 5 5 3 5 5 5 1 5 5 5 5 1 0
0 0 0 1 1 1 1 5 1 1 5 1 1 1 1 1 1 1 1 0
0 0 0 0 0 0 1 5 5 5 5 1 0 0 0 0 0 0 0 0
0 0 0 0 0 0 1 1 1 1 1 1 0 0 0 0 0 0 0 0
0 0 0 0 0 0 0 0 0 0 0 0 0 0 0 0 0 0 0 0
