0 0 0 0 0 0 0 0 0 0 0 0 0 0 0 0 0 0 0 0 
0 0 0 0 0 0 0 0 0 0 0 0 0 0 0 0 0 0 0 0 
0 0 0 0 0 0 0 0 0 0 0 0 0 0 0 0 0 0 0 0  
0 0 0 0 0 0 0 0 0 0 0 0 0 0 0 0 0 0 0 0  
0 0 0 0 1 1 1 1 1 1 0 0 0 0 0 0 0 0 0 0 
0 0 0 1 1 1 5 5 5 1 0 0 0 0 0 0 0 0 0 0 
0 0 0 1 1 1 3 5 3 1 0 0 0 0 0 0 0 0 0 0 
0 0 1 1 1 1 5 5 5 1 1 0 0 0 0 0 0 0 0 0 
0 0 1 1 5 5 5 3 5 5 1 0 0 0 0 0 0 0 0 0 
1 1 1 1 5 1 3 1 1 3 1 0 0 0 1 1 1 1 1 1 
1 1 5 5 5 1 5 1 1 5 1 1 1 1 1 5 5 2 2 1 
1 1 4 5 5 5 5 5 5 5 5 5 5 5 5 5 5 2 2 1 
1 1 1 1 1 1 5 1 1 1 3 1 5 1 1 5 5 2 2 1 
0 0 0 0 1 1 5 5 5 5 5 1 1 1 1 1 1 1 1 1 
0 0 0 0 1 1 1 1 1 1 1 1 0 0 0 0 0 0 0 0 
0 0 0 0 0 0 0 0 0 0 0 0 0 0 0 0 0 0 0 0 
0 0 0 0 0 0 0 0 0 0 0 0 0 0 0 0 0 0 0 0 
0 0 0 0 0 0 0 0 0 0 0 0 0 0 0 0 0 0 0 0 
0 0 0 0 0 0 0 0 0 0 0 0 0 0 0 0 0 0 0 0 
0 0 0 0 0 0 0 0 0 0 0 0 0 0 0 0 0 0 0 0 
