0 0 0 0 0 0 0 0 0 0 0 0 0 0 0 0 0 0 0 0
0 0 0 0 0 0 0 0 0 0 0 0 0 0 0 0 0 0 0 0
0 0 0 0 0 0 0 0 0 0 0 0 0 0 0 0 0 0 0 0
0 0 0 0 0 0 0 0 0 0 0 0 0 0 0 0 0 0 0 0
0 0 0 0 0 0 0 0 0 0 0 0 0 0 0 0 0 0 0 0 
0 0 0 0 0 0 0 0 0 0 0 0 0 0 0 0 0 0 0 0
0 0 0 0 0 0 1 1 1 1 1 1 0 0 0 0 0 0 0 0
0 0 0 0 0 0 1 4 5 5 5 1 1 1 1 0 0 0 0 0
0 0 0 0 0 0 1 1 5 5 3 1 5 5 1 0 0 0 0 0 
0 0 0 0 0 0 1 1 1 5 5 5 5 2 1 0 0 0 0 0
0 0 0 0 0 0 1 1 1 5 1 1 1 2 1 0 0 0 0 0 
0 0 0 0 0 0 1 5 3 5 1 0 1 2 1 0 0 0 0 0
0 0 0 0 0 0 1 5 3 5 1 1 1 1 1 0 0 0 0 0 
0 0 0 0 0 0 1 5 5 5 1 0 0 0 0 0 0 0 0 0 
0 0 0 0 0 0 1 1 1 1 1 0 0 0 0 0 0 0 0 0
0 0 0 0 0 0 0 0 0 0 0 0 0 0 0 0 0 0 0 0 
0 0 0 0 0 0 0 0 0 0 0 0 0 0 0 0 0 0 0 0 
0 0 0 0 0 0 0 0 0 0 0 0 0 0 0 0 0 0 0 0 
0 0 0 0 0 0 0 0 0 0 0 0 0 0 0 0 0 0 0 0 
0 0 0 0 0 0 0 0 0 0 0 0 0 0 0 0 0 0 0 0 

